________
________
________
________
________
________
________
________
________
________
________
b_______
b_______
b_______
b_______
b_______
b_______
b_______
b_______
b_______
b_______
b_______
b__P____
bbbbbbbb
________
________
________
________
________
________